1/8,1/1,0/1
1/8,1/1,1/1
1/8,1/1,2/1
1/8,1/1,3/1
1/8,1/1,4/1
3/8,1/3,5/1
,1/3,6/1
,1/3,7/1
