1/8,1/1,0/1
1/8,1/1,1/1
1/8,1/1,2/1
1/8,1/1,3/1
1/2,1/4,4/1
,1/4,5/1
,1/4,6/1
,1/4,7/1
